"a" = (/turf/closed/wall/train_wall_front,/area/shuttle/arrival)
"m" = (/turf/open/floor/city_floor/train_floor,/area/shuttle/arrival)
"s" = (/turf/open/floor/city_floor/train_carpet,/area/shuttle/arrival)

(1,1,1) = {"
aaa
aaa
msm
msm
msm
msm
msm
msm
msm
msm
msm
msm
msm
msm
msm
msm
msm
msm
aaa
aaa
"}
